#FRANCE 0.1
ALS = "countriesmrn/Alsace.txt"
ART = "countriesmrn/Artois.txt"
BRG = "countriesmrn/Burgundy.txt"
CHM = "countriesmrn/Champagne.txt"
DAU = "countriesmrn/Dauphine.txt"
FRC = "countriesmrn/FrancheComte.txt"
NRM = "countriesmrn/Normandy.txt"
ORL = "countriesmrn/Orleans.txt"
GAS = "countriesmrn/Gascony.txt"
PIC = "countriesmrn/Picardy.txt"
PRI = "countriesmrn/Paris.txt"
PRO = "countriesmrn/Provence.txt"
POI = "countriesmrn/Poitou.txt"
#FRANCE 0.2
AUV = "countriesmrn/Auvergne.txt"
ARP = "countriesmrn/Arpitania.txt"
#FRANCE 0.3
GUE = "countriesmrn/Guernsey.txt"
JER = "countriesmrn/Jersey.txt"
NCE = "countriesmrn/Nice.txt"
#FRANCE 0.4
LIM = "countriesmrn/Limousin.txt"
#FRANCE 0.5
ANJ = "countriesmrn/Anjou.txt"
BEA = "countriesmrn/Bearn.txt"
BRR = "countriesmrn/Berry.txt"
BOU = "countriesmrn/Bourbonnais.txt"
LRA = "countriesmrn/Lorraine.txt"
LYO = "countriesmrn/Lyon.txt"
#BENELUX 0.1.1
BRB = "countriesmrn/Brabant.txt"
FLA = "countriesmrn/Flanders.txt"
FRI = "countriesmrn/Friesland.txt"
WAL = "countriesmrn/Wallonia.txt"
#BENELUX 0.3.1
HLL = "countriesmrn/Holland.txt"
#BENELUX 0.5.1
GEL = "countriesmrn/Guelders.txt"
#MAINLAND IBERIA 0.1.2
ARA = "countriesmrn/Aragon.txt"
ATU = "countriesmrn/Asturias.txt"
BAE = "countriesmrn/Balearics.txt"
CAS = "countriesmrn/Castille.txt"
EXT = "countriesmrn/Extremadura.txt"
GIB = "countriesmrn/Giblartar.txt"
LMA = "countriesmrn/LaMancha.txt"
LEO = "countriesmrn/Leon.txt"
MUR = "countriesmrn/Murcia.txt"
VAL = "countriesmrn/Valencia.txt"
#MAINLAND IBERIA 0.4.0
AGV = "countriesmrn/Algarve.txt"
#MAINLAND IBERIA 0.5.1
ALN = "countriesmrn/Alentejo.txt"
CTB = "countriesmrn/Cantabria.txt"
EAD = "countriesmrn/EasternAndalusia.txt"
#MACARONESIA 0.1.2
AZO = "countriesmrn/Azores.txt"
CNR = "countriesmrn/Canaries.txt"
MDR = "countriesmrn/Madeira.txt"
#BRITISH ISLES 0.2.1
CRN = "countriesmrn/Cornwall.txt"
EAG = "countriesmrn/EastAnglia.txt"
IOM = "countriesmrn/Mann.txt"
LON = "countriesmrn/London.txt"
MER = "countriesmrn/Mercia.txt"
NRT = "countriesmrn/Northumbria.txt"
ORK = "countriesmrn/Orkney.txt"
SHE = "countriesmrn/Shetlands.txt"
SUS = "countriesmrn/Sussex.txt" #à¶ž 69 funny
WSX = "countriesmrn/Wessex.txt"
YOR = "countriesmrn/Yorkshire.txt"
#BRITISH ISLES 0.5.1
ABD = "countriesmrn/Aberdeenshire.txt"
CNN = "countriesmrn/Connaught.txt"
CUM = "countriesmrn/Cumbria.txt"
LCS = "countriesmrn/Lancashire.txt"
LEI = "countriesmrn/Leinster.txt"
MOY = "countriesmrn/Moray.txt"
MTR = "countriesmrn/Mhumhain.txt"
STH = "countriesmrn/Strathclyde.txt"
#GERMANY 0.2.2
BAD = "countriesmrn/Baden.txt"
BRN = "countriesmrn/Brandenburg.txt"
OFL = "countriesmrn/Ostfriesland.txt"
SAR = "countriesmrn/Saarland.txt"
#GERMANY 0.5.1
ANH = "countriesmrn/Anhalt.txt"
BRE = "countriesmrn/Bremen.txt"
BSW = "countriesmrn/Brunswick.txt"
CLG = "countriesmrn/Cologne.txt"
FCN = "countriesmrn/Franconia.txt"
HLS = "countriesmrn/Holstein.txt"
LPP = "countriesmrn/Lippe.txt"
MUN = "countriesmrn/Munster.txt"
NAS = "countriesmrn/Nassau.txt"
OLD = "countriesmrn/Oldenburg.txt"
OSN = "countriesmrn/Osnabruck.txt"
PFZ = "countriesmrn/Palatinate.txt"
TIR = "countriesmrn/Trier.txt"
WPH = "countriesmrn/Westphalia.txt"
#ALPS 0.2.2
STY = "countriesmrn/Styria.txt"
LCH = "countriesmrn/Liechtenstein.txt"
#ALPS 0.2.4
TYR = "countriesmrn/Tyrol.txt"
#ALPS 0.3.1
BGN = "countriesmrn/Burgenland.txt"
CRT = "countriesmrn/Carinthia.txt"
GRI = "countriesmrn/Grisons.txt"
JUR = "countriesmrn/Jura.txt"
VLL = "countriesmrn/Valais.txt"
#ALPS 0.5.1
FRB = "countriesmrn/Fribourg.txt"
LAU = "countriesmrn/LowerAustria.txt"
RMN = "countriesmrn/Romandy.txt"
SLZ = "countriesmrn/Salzburg.txt"
TIC = "countriesmrn/Ticino.txt"
UAU = "countriesmrn/UpperAustria.txt"
#ALPS 0.5.2
BER = "countriesmrn/Bern.txt"
#SCANDINAVIA 0.2.3
ALA = "countriesmrn/Aland.txt"
BOR = "countriesmrn/Bornholm.txt"
FAR = "countriesmrn/Faroe.txt"
GTL = "countriesmrn/Gotland.txt"
SCA = "countriesmrn/Scania.txt"
#SCANDINAVIA 0.3.1
JUT = "countriesmrn/Jutland.txt"
#SCANDINAVIA 0.5.1
BOH = "countriesmrn/Bohuslan.txt"
FYN = "countriesmrn/Funen.txt"
GTA = "countriesmrn/Gotaland.txt"
JMT = "countriesmrn/Jamtland.txt"
NRR = "countriesmrn/Norrland.txt"
OGL = "countriesmrn/Ostergotland.txt"
TRD = "countriesmrn/Trondelag.txt"
SMA = "countriesmrn/Smaland.txt"
VGL = "countriesmrn/Vastergotland.txt"
#ZAPADOSLAVIA 0.2.2
POM = "countriesmrn/Pomerania.txt"
#ZAPADOSLAVIA (West Slavia) 0.2.4
GAL = "countriesmrn/Galicia.txt"
GPL = "countriesmrn/GreaterPoland.txt"
LPL = "countriesmrn/LesserPoland.txt"
LUS = "countriesmrn/Lusatia.txt"
MRV = "countriesmrn/Moravia.txt"
MZV = "countriesmrn/Mazovia.txt"
POD = "countriesmrn/Podlachia.txt"
SDT = "countriesmrn/Sudetenland.txt"
#ZAPADOSLAVIA 0.5.2
LCZ = "countriesmrn/Leczyca.txt"
SDZ = "countriesmrn/Sieradz.txt"
USI = "countriesmrn/UpperSilesia.txt"
#BALTIC 0.2.5
CLT = "countriesmrn/CentralLithuania.txt"
COU = "countriesmrn/Courland.txt"
LIV = "countriesmrn/Livonia.txt"
LTG = "countriesmrn/Latgalia.txt"
OSE = "countriesmrn/Saaremaa.txt"
PKV = "countriesmrn/Pskov.txt"
PRS = "countriesmrn/OldPrussia.txt"
RGA = "countriesmrn/Riga.txt"
SET = "countriesmrn/Seto.txt"
SMG = "countriesmrn/Semigallia.txt"
ZMT = "countriesmrn/Zemaitija.txt"
#BALTIC 0.5.1
AUK = "countriesmrn/Aukstaitija.txt"
MSR = "countriesmrn/Masuria.txt"
PLI = "countriesmrn/LithuaniaMinor.txt"
SDV = "countriesmrn/Sudovia.txt"
WRM = "countriesmrn/Warmia.txt"
#FINLAND 0.3.0
ING = "countriesmrn/Ingria.txt"
KVE = "countriesmrn/Kvenland.txt"
TOR = "countriesmrn/Tornedalen.txt"
VEP = "countriesmrn/Vepsia.txt"
#FINLAND 0.4.0
SAV = "countriesmrn/Savonia.txt"
#FINLAND 0.5.1
OBT = "countriesmrn/Ostrobothnia.txt"
STK = "countriesmrn/Satakunta.txt"
TAV = "countriesmrn/Tavastia.txt"
UUS = "countriesmrn/Uusimaa.txt"
#UKRAINE 0.3.0
CHE = "countriesmrn/Chernigov.txt"
CUK = "countriesmrn/Subcarpathia.txt"
DNT = "countriesmrn/Donetsk.txt"
KIV = "countriesmrn/Kyiv.txt"
ODS = "countriesmrn/Odessa.txt"
NRU = "countriesmrn/Novorossiya.txt"
PDL = "countriesmrn/Podolia.txt"
PLS = "countriesmrn/Polesia.txt"
SUK = "countriesmrn/Sloboda.txt"
ZPZ = "countriesmrn/Zaporizhzhia.txt"
#UKRAINE 0.5.1
VLH = "countriesmrn/Volhynia.txt"
#ROMANIA 0.3.0
BNT = "countriesmrn/Banat.txt"
DBJ = "countriesmrn/Dobruja.txt"
GAG = "countriesmrn/Gagauzia.txt"
PRT = "countriesmrn/Partium.txt"
TNI = "countriesmrn/Transnistria.txt"
WLL = "countriesmrn/Wallachia.txt"
#ROMANIA 0.5.1
BCV = "countriesmrn/Bucovina.txt"
CMN = "countriesmrn/Cumania.txt"
SZK = "countriesmrn/Szeklerland.txt"
#BELARUS 0.3.0
PLT = "countriesmrn/Polotsk.txt"
SMO = "countriesmrn/Smolensk.txt"
#RUSSIA 0.3.0
ARK = "countriesmrn/Arkhangelsk.txt"
NOV = "countriesmrn/Novgorod.txt" 
RYA = "countriesmrn/Ryazan.txt"
VLD = "countriesmrn/Vladimir.txt"
MRD = "countriesmrn/Mordovia.txt"
#RUSSIA 0.4.1
MSH = "countriesmrn/Mishar.txt"
#RUSSIA 0.5.1
KCH = "countriesmrn/KarachayCherkessia.txt"
ONB = "countriesmrn/Orenburg.txt"
PRM = "countriesmrn/Perm.txt"
URA = "countriesmrn/Yaik.txt"
#RUSSIA 0.5.2
DOL = "countriesmrn/Dolgania.txt"
KMS = "countriesmrn/Kamassia.txt"
NAN = "countriesmrn/Nanai.txt"
#ITALY 0.3.1
ANC = "countriesmrn/Ancona.txt"
AOS = "countriesmrn/Aosta.txt"
FRU = "countriesmrn/Friuli.txt"
LIG = "countriesmrn/Genoa.txt"
LOM = "countriesmrn/Lombardy.txt"
SIC = "countriesmrn/Sicily.txt"
SRD = "countriesmrn/Sardinia.txt"
TRS = "countriesmrn/Trieste.txt"
#ITALY 0.5.2
FMR = "countriesmrn/Ferrara.txt"
PMA = "countriesmrn/Parma.txt"
RMG = "countriesmrn/Romagna.txt"
TRT = "countriesmrn/Trent.txt"
#YUGOSLAVIA 0.3.1
DAL = "countriesmrn/Dalmatia.txt"
FIU = "countriesmrn/Fiume.txt"
HZB = "countriesmrn/HerzegBosnia.txt"
IST = "countriesmrn/Istria.txt"
KRJ = "countriesmrn/Krajina.txt"
RAG = "countriesmrn/Ragusa.txt"
SLA = "countriesmrn/Slavonia.txt"
SRP = "countriesmrn/Srpska.txt"
VOJ = "countriesmrn/Vojvodina.txt"
#YUGOSLAVIA 0.5.1
ILR = "countriesmrn/Illirida.txt"
SND = "countriesmrn/Sandzak.txt"
#GREECE 0.3.1
AEG = "countriesmrn/Aegan.txt"
ATH = "countriesmrn/Athens.txt"
CRE = "countriesmrn/Crete.txt"
EPI = "countriesmrn/Epirus.txt"
ION = "countriesmrn/Ionian.txt"
MCD = "countriesmrn/Macedonia.txt"
PLP = "countriesmrn/Peloponnese.txt"
THR = "countriesmrn/Thrace.txt"
#GREECE 0.5.1
THE = "countriesmrn/Thessaly.txt"
#BULGARIA 0.4.0
ERM = "countriesmrn/Rumelia.txt"
#CAUCASUS 0.3.1
ADJ = "countriesmrn/Adjara.txt"
ATR = "countriesmrn/Astrakhan.txt"
NAK = "countriesmrn/Nakhchivan.txt"
NKR = "countriesmrn/Artsakh.txt"
SAZ = "countriesmrn/SouthAzerbaijan.txt"
#CAUCASUS 0.4.1
AVA = "countriesmrn/Avaria.txt"
JVK = "countriesmrn/Javakheti.txt"
KUM = "countriesmrn/Kumykia.txt"
LZG = "countriesmrn/Lezgistan.txt"
TMG = "countriesmrn/Talysh.txt"
#ANATOLIA 0.3.1
PON = "countriesmrn/Pontus.txt"
WAR = "countriesmrn/WestArmenia.txt"
#ANATOLIA 0.4.1
ANT = "countriesmrn/Antioch.txt"
BTH = "countriesmrn/Bithynia.txt"
CDR = "countriesmrn/Candar.txt"
CIL = "countriesmrn/Cilica.txt"
CPP = "countriesmrn/Cappadocia.txt"
EDS = "countriesmrn/Edessa.txt"
ERE = "countriesmrn/Eretna.txt"
KPP = "countriesmrn/Kars.txt"
KRM = "countriesmrn/Karaman.txt"
KRS = "countriesmrn/Karasi.txt"
LAZ = "countriesmrn/Lazistan.txt"
LYD = "countriesmrn/Lydia.txt"
NCP = "countriesmrn/NorthCyprus.txt"
RMZ = "countriesmrn/Ramazan.txt"
SMY = "countriesmrn/Smyrna.txt"
TEK = "countriesmrn/Teke.txt"
ZAZ = "countriesmrn/Zazaistan.txt"
ZTS = "countriesmrn/ZoneoftheStraits.txt"
#SIBERIA 0.3.1
ABY = "countriesmrn/Agin.txt"
GUK = "countriesmrn/GreenUkraine.txt"
KAM = "countriesmrn/Kamchatka.txt"
SAK = "countriesmrn/Sakhalin.txt"
STA = "countriesmrn/SiberianTatar.txt"
UOB = "countriesmrn/Ust-Orda.txt"
URL = "countriesmrn/Ural.txt"
#NORTHERN NORTH AMERICA 0.4.0
ABT = "countriesmrn/Alberta.txt"
ACA = "countriesmrn/Acadia.txt"
ALE = "countriesmrn/Aleut.txt"
ALK = "countriesmrn/Alaska.txt"
ANI = "countriesmrn/Anishinaabe.txt"
BCL = "countriesmrn/BritishColumbia.txt"
CEE = "countriesmrn/Cree.txt"
CSC = "countriesmrn/Cascadia.txt"
HDA = "countriesmrn/Haida.txt"
IRO = "countriesmrn/Iroquois.txt"
LAB = "countriesmrn/Labrador.txt"
MTB = "countriesmrn/Manitoba.txt"
NBW = "countriesmrn/NewBrunswick.txt"
NFL = "countriesmrn/NewfoundlandLabrador.txt"
NFO = "countriesmrn/Newfoundland.txt"
NSC = "countriesmrn/NovaScotia.txt"
NTV = "countriesmrn/Nunatsiavut.txt"
NUN = "countriesmrn/Nunavut.txt"
NVK = "countriesmrn/Nunavik.txt"
NWT = "countriesmrn/NorthwestTerritories.txt"
PEI = "countriesmrn/PrinceEdwardIsland.txt"
PMQ = "countriesmrn/StPierreMiquelon.txt"
ONT = "countriesmrn/Ontario.txt"
SAG = "countriesmrn/Saguenay.txt"
SKT = "countriesmrn/Saskatchewan.txt"
VAN = "countriesmrn/Vancouver.txt"
WAB = "countriesmrn/Wabanaki.txt"
YUK = "countriesmrn/Yukon.txt"
#CENTRAL NORTH AMERICA 0.4.0
ABM = "countriesmrn/Alabama.txt"
AKS = "countriesmrn/Arkansas.txt"
APL = "countriesmrn/Appalachia.txt"
ARZ = "countriesmrn/Arizona.txt"
AZT = "countriesmrn/Aztlan.txt"
CLD = "countriesmrn/Colorado.txt"
CLF = "countriesmrn/California.txt"
CNT = "countriesmrn/Connecticut.txt"
DLW = "countriesmrn/Delaware.txt"
FLO = "countriesmrn/Florida.txt"
GRG = "countriesmrn/Georgia.txt"
IDH = "countriesmrn/Idaho.txt"
ILL = "countriesmrn/Illinois.txt"
IND = "countriesmrn/Indiana.txt"
IOW = "countriesmrn/Iowa.txt"
IWA = "countriesmrn/NativeIowa.txt"
KNS = "countriesmrn/Kansas.txt"
KTY = "countriesmrn/Kentucky.txt"
LOU = "countriesmrn/Louisiana.txt"
MCH = "countriesmrn/Michigan.txt"
MIN = "countriesmrn/Minnesota.txt"
MNE = "countriesmrn/Maine.txt"
MTA = "countriesmrn/Montana.txt"
MRL = "countriesmrn/Maryland.txt"
MSK = "countriesmrn/Muskogee.txt"
MSP = "countriesmrn/Mississippi.txt"
MSS = "countriesmrn/Missouri.txt"
MST = "countriesmrn/Massachusetts.txt"
NAF = "countriesmrn/NewAfrika.txt"
NCR = "countriesmrn/NorthCarolina.txt"
NDK = "countriesmrn/NorthDakota.txt"
NEB = "countriesmrn/Nebraska.txt"
NEG = "countriesmrn/NewEngland.txt"
NHP = "countriesmrn/NewHampshire.txt"
NJE = "countriesmrn/NewJersey.txt"
NMX = "countriesmrn/NewMexico.txt"
NVD = "countriesmrn/Nevada.txt"
NYO = "countriesmrn/NewYork.txt"
OHO = "countriesmrn/Ohio.txt"
OKL = "countriesmrn/Oklahoma.txt"
ORG = "countriesmrn/Oregon.txt"
PEN = "countriesmrn/Pennsylvania.txt"
RIS = "countriesmrn/RhodeIsland.txt"
SCR = "countriesmrn/SouthCarolina.txt"
SDK = "countriesmrn/SouthDakota.txt"
SHO = "countriesmrn/Shoshone.txt"
SIO = "countriesmrn/Sioux.txt"
TEN = "countriesmrn/Tennessee.txt"
TEX = "countriesmrn/Texas.txt"
UTA = "countriesmrn/Utah.txt"
VMT = "countriesmrn/Vermont.txt"
VRG = "countriesmrn/Virginia.txt"
WSC = "countriesmrn/Wisconsin.txt"
WSH = "countriesmrn/Washington.txt"
WVR = "countriesmrn/WestVirginia.txt"
WYO = "countriesmrn/Wyoming.txt"
#CARRIBBEANS 0.4.0
BMD = "countriesmrn/Bermuda.txt"
#JAPAN 0.4.1
AIN = "countriesmrn/Ainu.txt"
EZO = "countriesmrn/Hokkaido.txt"
KYU = "countriesmrn/Kyushu.txt"
RYU = "countriesmrn/Ryukyu.txt"
SHI = "countriesmrn/Shikoku.txt"
#MASHRIQ 0.5.0
ALW = "countriesmrn/Alawite.txt"
APP = "countriesmrn/Aleppo.txt"
BSR = "countriesmrn/Basra.txt"
DMS = "countriesmrn/Damascus.txt"
DRU = "countriesmrn/Druze.txt"
TML = "countriesmrn/Turkmeneli.txt"
TRP = "countriesmrn/Tripoli.txt"
YZD = "countriesmrn/Yezidistan.txt"
#ARABIA 0.5.0
ASR = "countriesmrn/Asir.txt"
BKH = "countriesmrn/BaniKhalid.txt"
DHO = "countriesmrn/Dhofar.txt"
HDH = "countriesmrn/Hadhramaut.txt"
HJZ = "countriesmrn/Hejaz.txt"
JSH = "countriesmrn/Hail.txt"
KTH = "countriesmrn/Kathiri.txt"
LHJ = "countriesmrn/Lahej.txt"
MHR = "countriesmrn/Mahra.txt"
NJR = "countriesmrn/Najran.txt"
QIT = "countriesmrn/Quaiti.txt"
ORM = "countriesmrn/Ormus.txt"
#ARBAIA 0.5.2
ADI = "countriesmrn/AbuDhabi.txt"
#IRAN 0.5.0
BDH = "countriesmrn/Badakhshan.txt"
GIL = "countriesmrn/Gilan.txt"
HRT = "countriesmrn/Herat.txt"
HZR = "countriesmrn/Hazarajat.txt"
JAL = "countriesmrn/Jalayirids.txt"
KHO = "countriesmrn/Khorasan.txt"
KHU = "countriesmrn/Khuzestan.txt"
LOR = "countriesmrn/Lorestan.txt"
QSH = "countriesmrn/Qashqai.txt"
STU = "countriesmrn/SouthernTurkestan.txt"
TBR = "countriesmrn/Tabaristan.txt"
TKH = "countriesmrn/TurkishKhorasan.txt"
TSH = "countriesmrn/TurkmenSahra.txt"
#CENTRAL ASIA 0.5.0
NOG = "countriesmrn/Nogai.txt"
SMR = "countriesmrn/Semirechye.txt"
#CENTRAL ASIA 0.5.1
KOK = "countriesmrn/Kokand.txt"



